##################################################
#@@@@@@@@@@@@@@@@@@@@@@@@@@@@@@@@@@@@@@@@@@@@@@@@#
#@                                              @#
#@                                              @#
#@     @@@@@@@@@@                @@@@@@@@@@     @#
#@     @@@@@@@@@@                @@@@@@@@@@     @#
#@     @@@@@@@@@@                @@@@@@@@@@     @#
#@     @@@@@@@@@@                @@@@@@@@@@     @#
#@                                              @#
#@                                              @#
#@                                              @#
#@                                              @#
#@                                              @#
#@     @@@@@@@@@@                @@@@@@@@@@     @#
#@     @@@@@@@@@@                @@@@@@@@@@     @#
#@     @@@@@@@@@@                @@@@@@@@@@     @#
#@     @@@@@@@@@@                @@@@@@@@@@     @#
#@                                              @#
#@                                              @#
#@@@@@@@@@@@@@@@@@@@@@@@@@@@@@@@@@@@@@@@@@@@@@@@@#
##################################################