##################################################
#@@@@@@@@@@@@@@@@@@@@@@@@@@@@@@@@@@@@@@@@@@@@@@@@#
#@                                              @#
#@                                              @#
#@                                              @#
#@                                              @#
#@                                              @#
#@                                              @#
#@                                              @#
#@                                              @#
#@                                              @#
#@                                              @#
#@                                              @#
#@                                              @#
#@                                              @#
#@                                              @#
#@                                              @#
#@                                              @#
#@                                              @#
#@@@@@@@@@@@@@@@@@@@@@@@@@@@@@@@@@@@@@@@@@@@@@@@@#
##################################################