##################################################
#                                                #
#                                                #
#           @@@@@@@                              #
#          @@@@@@@@                              #
#         @@                                     #
#        @@                                      #
#       @@                                       #
#       @@                 @@            @@      #
#       @@                 @@            @@      #
#       @@                 @@            @@      #
#       @@             @@@@@@@@@@    @@@@@@@@@@  #
#       @@                 @@            @@      #
#        @@                @@            @@      #
#         @@               @@            @@      #
#          @@@@@@@@                              #
#           @@@@@@@                              #
#                                                #
#                                                #
#                                                #
##################################################
