##################################################
#                                                #
#                                                #
#               @                 @              #
#               @                 @              #
#               @                 @              #
#               @                 @              #
#               @                 @              #
#               @                 @              #
#               @                 @              #
#               @                 @              #
#   @                                        @   #
#    @                                      @    #
#     @                                    @     #
#      @                                  @      #
#       @                                @       #
#        @@@@@@@@@@@@@@@@@@@@@@@@@@@@@@@@        #
#                                                #
#                                                #
#                                                #
##################################################
