##################################################
#                                                #
#                                                #
#                                          @     #
#                                          @     #
#        @@@@@@@@@@@@@@@@@@@@@@@@@@@@@     @     #
#        @@@@@@@@@                  @@     @     #
#        @@@@@@@@@                  @@     @     #
#        @@@@@@@@@     @@@@@        @@     @     #
#                                   @@     @     #
#                                   @@     @     #
#               @@@@   @@@@@@@@@    @@     @     #
#               @@@@   @@@@@@@@@    @@     @     #
#      @        @@@@   @@@@@@@@@    @@     @     #
#     @@@       @@@@   @@@@@@@@@    @@     @     #
#   @@@@@@@     @@@@   @@@@@        @@     @     #
#     @@@       @@@@   @@@@@        @@     @     #
#      @                            @@           #
#                                   @@           #
#                  @@@@@@@@@@@@@@@@@@@           #
##################################################
